999999999999999999999999
9999999999PA999999999999
99DDDDDDDDDDDDDDDDDDDD99
99DDDDDDDDDDDDDDDDDDDD99
99DDDDDDDDDDDDDDDDDDDD99
99DDDDDDDDDDDDDDDDDDDD99
99DDDDDDDDDDDDDDDDDDDDh9
99DDDDDDDDDDDDDDDDDDDD99
99DDDDDDDDDDDDDDDDDDDD99
9tDDDDDDDDDDDDDDDDDDDD99
99DDDDDDDDDDDDDDDDDDDD99
99DDDDDDDDDDDDDDDDDDDD99
999999999999TH9999999999
999999999999999999999999