////////////////////////
////////////////////////
////////////////////////
////////////////////////
////BBBBBBBBBBBBBBBB////
////BBBBBBBBBBBBBBBB////
////BBDDDDDDDDDDDDBB////
////BBDDDDDDDDDDDDBB////
////BBDDDDDDDDDDDDBB////
////BBDDDDDDDDDDDDaB////
////BBDDDDDDDDDDDDhB////
////BBDDDDDDDDDDDDBB////
////BBBBBBBBBBBBBBBB////
////BBBBBBBBBBBBBBBB////