////////////////////////
////////////////////////
////////////////////////
////////////////////////
////BBBBBBBBBBBBBBBB////
////BBBBBBBBBBBBBBBB////
////BBDDDDDDDDDDDDBB////
////BBDDDDDDDDDDDDBB////
////BBDDDDDDDDDDDDBB////
////BBDDDDDDDDDDDDAB////
////BBDDDDDDDDDDDDHB////
////BBDDDDDDDDDDDDBB////
////BBBBBBBBBBBBBBBB////
////BBBBBBBBBBBBBBBB////