BBBBBBBBBPABBBBBBBBBBB
BDDDDDDDDDDDDDDDDDDDDB
BDDDDDDDDDDDDDDDDDDDDB
BDDDDDDDDDDDDDDDDDDDDB
BDDDDDDDDDDDDDDDDDDDDB
BDDDDDDDDDDDDDDDDDDDDB
tDDDDDDDDDDDDDDDDDDDDh
BDDDDDDDDDDDDDDDDDDDDB
BDDDDDDDDDDDDDDDDDDDDB
BDDDDDDDDDDDDDDDDDDDDB
BDDDDDDDDDDDDDDDDDDDDB
BBBBBBBBBTHBBBBBBBBBBB