BBBBBBBBBBBBBBBBBBBBBBBB
BBBBBBBBBBPABBBBBBBBBBBB
BBDDDDDDDDDDDDDDDDDDDDBB
BBDDDDDDDDDDDDDDDDDDDDBB
BBDDDDDDDDDDDDDDDDDDDDBB
BBDDDDDDDDDDDDDDDDDDDD9B
BBDDDDDDDDDDDDDDDDDDDDhB
BBDDDDDDDDDDDDDDDDDDDDBB
B9DDDDDDDDDDDDDDDDDDDDBB
BtDDDDDDDDDDDDDDDDDDDDBB
BBDDDDDDDDDDDDDDDDDDDDBB
BBDDDDDDDDDDDDDDDDDDDDBB
BBBBBBBBBBBBTHBBBBBBBBBB
BBBBBBBBBBBBBBBBBBBBBBBB