////////////////////////
////////////////////////
//BBBBBBBBBBBBBBBBBBBB//
//BBBBBBBBBBBBBBBBBBBB//
//BBDDDDDDDDDDDDDDDDBB//
//BBDDDDDDDDDDDDDDDDBB//
//BBDDDDDDDDDDDDDDDDBB//
//BBDDDDDDDDDDDDDDDDBB//
//BBDDDDDDDDDDDDDDDDBB//
//BpDDDDDDDDDDDDDDDDAB//
//BtDDDDDDDDDDDDDDDDHB//
//BBDDDDDDDDDDDDDDDDBB//
//BBBBBBBBBBBBBBBBBBBB//
//BBBBBBBBBBBBBBBBBBBB//