////////////////////////
////////////////////////
//BBBBBBBBBBBBBBBBBBBB//
//BBBBBBBBBBBBBBBBBBBB//
//BBDDDDDDDDDDDDDDDDBB//
//BBDDDDDDDDDDDDDDDDBB//
//BBDDDDDDDDDDDDDDDDBB//
//BBDDDDDDDDDDDDDDDDBB//
//BBDDDDDDDDDDDDDDDDBB//
//BpDDDDDDDDDDDDDDDDaB//
//BtDDDDDDDDDDDDDDDDhB//
//BBDDDDDDDDDDDDDDDDBB//
//BBBBBBBBBBBBBBBBBBBB//
//BBBBBBBBBBBBBBBBBBBB//