//BBBBBBBBBBBBBBBBBBBB//
//BBBBBBBBBPABBBBBBBBB//
//BBDDDDDDDDDDDDDDDDBB//
//BBDDDDDDDDDDDDDDDDBB//
//BBDDDDDDDDDDDDDDDDBB//
//BBDDDDDDDDDDDDDDDDBB//
//BBDDDDDDDDDDDDDDDDBB//
//BBDDDDDDDDDDDDDDDDBB//
//BBDDDDDDDDDDDDDDDDBB//
//BpDDDDDDDDDDDDDDDDBB//
//BtDDDDDDDDDDDDDDDDBB//
//BBDDDDDDDDDDDDDDDDBB//
//BBBBBBBBBBBBBBBBBBBB//
//BBBBBBBBBBBBBBBBBBBB//