BBBBBBBBBBBBBBBBBBBBBBBB
BBBBBBBBBBBPABBBBBBBBBBB
BBDDDDDDDDDDDDDDDDDDDDBB
BBDDDDDDDDDDDDDDDDDDDDBB
BBDDDDDDDDDDDDDDDDDDDDBB
BBDDDDDDDDDDDDDDDDDDDDBB
BBDDDDDDDDDDDDDDDDDDDDBB
BBDDDDDDDDDDDDDDDDDDDDBB
BBDDDDDDDDDDDDDDDDDDDDBB
BBDDDDDDDDDDDDDDDDDDDDBB
BBDDDDDDDDDDDDDDDDDDDDBB
BBDDDDDDDDDDDDDDDDDDDDBB
BBBBBBBBBBBTHBBBBBBBBBBB
BBBBBBBBBBBBBBBBBBBBBBBB