BBBBBBBBBBBBBBBBBBBBBBBB
BBBBBBBBBBBBBBBBBBBBBBBB
BBDDDDDDDDDDDDDDBBPABBBB
BBDDDDDDDDDDDDDDDDDDDDBB
BBDDDDDDDDDDDDDDDDDDDDBB
BBDDDDDDDDDDDDDDDDDDDDBB
BBDDDDDDDDDDDDDDDDDDDDBB
BBDDDDDDDDDDDDDDDDDDDDBB
BBDDDDDDDDDDDDDDDDDDDDBB
BBDDDDDDDDDDDDDDDDDDDDBB
BBDDDDDDDDDDDDDDDDDDDDBB
BBDDDDDDDDDDDDDDDDDDDDBB
BBBBBBBBBBBBBBBBBBBBBBBB
BBBBBBBBBBBBBBBBBBBBBBBB