BBBBBBBBBBBBBBBBBBBBBBBB
BBBBBBBBBBBBBBBBBBPABBBB
BBDDDDDDDDDDDDBBDDDDDDBB
BBDDDDDDDDDDDDBBDDDDDDBB
BBDDDDDDDDDDDDBBDDDDDDBB
BBDDDDDDDDDDDDDDDDDDDDBB
BBDDDDDDDDDDDDDDDDDDDDBB
BtDDDDDDDDDDDDDDDDDDDDhB
BBDDDDDDDDDDDDDDDDDDDDBB
BBDDDDDBBDDDDDDDDDDDDDBB
BBDDDDDBBDDDDDDDDDDDDDBB
BBDDDDDBBDDDDDDDDDDDDDBB
BBBBBBBBBBBTHBBBBBBBBBBB
BBBBBBBBBBBBBBBBBBBBBBBB