BBBBBBBBBBBBBBBBBBBBBBBB
BBBBBBBBBBBPABBBBBBBBBBB
BBDDDDDDDDDDDDDDDDDDDDBB
BBDDDDDDDDDDDDDDDDDDDDBB
BBDDDDDDDDDDDDDDDDDDDDBB
BBDDDDDDDDDDDDDDDDDDDDBB
BBDDDDDDDDDDDDDDDDDDDDBB
BBDDDDDDDDDDDDDDDDDDDDBB
BBDDDDDDDDDDDDDDDDDDDDBB
BBDDDDDDDDDDDDDDDDDDDDBB
BBDDDDDDDDDDDDDDDDDDDDBB
BBDDDDDDDDDDDDDDDDDDDDBB
BBBBBBBBBBBthBBBBBBBBBBB
BBBBBBBBBBBBBBBBBBBBBBBB