BBBBBBBBBBBBBBBBBBBBBBBB
BBBBBBBBBBBBBBBBBBBBBBBB
BBDDDDDBBDDDDDDDDDDDDDBB
BBDDDDDBBDDDDDDDDDDDDDBB
BBDDDDDBBDDDDDDDDDDDDDBB
BBDDDDDDDDDDDDDDDDDDDDBB
BpDDDDDDDDDDDDDDDDDDDDBB
BtDDDDDDDDDDDDDDDDDDDDBB
BBDDDDDDDDDDDDDDDDDDDDBB
BBDDDDDDDDDDDDBBDDDDDDBB
BBDDDDDDDDDDDDBBDDDDDDBB
BBDDDDDDDDDDDDBBDDDDDDBB
BBBBBBBBBBBTHBBBBBBBBBBB
BBBBBBBBBBBBBBBBBBBBBBBB