BBBBBBBBBBBBBBBBBBBBBBBB
BBBBBBBBBBBBBBBBBBBBBBBB
BBDDDDDBBDDDDDDDDDDDDDBB
BBDDDDDBBDDDDDDDDDDDDDBB
BBDDDDDBBDDDDDDDDDDDDDBB
BBDDDDDDDDDDDDDDDDDDDDBB
BPDDDDDDDDDDDDDDDDDDDDBB
BTDDDDDDDDDDDDDDDDDDDDBB
BBDDDDDDDDDDDDDDDDDDDDBB
BBDDDDDDDDDDDDBBDDDDDDBB
BBDDDDDDDDDDDDBBDDDDDDBB
BBDDDDDDDDDDDDBBDDDDDDBB
BBBBBBBBBBBthBBBBBBBBBBB
BBBBBBBBBBBBBBBBBBBBBBBB