BBBBBBBBBBBBBBBBBBBBBBBB
BBBBBBBBBBBPABBBBBBBBBBB
BBBBDDDDDDDDDDDDDDDDBBBB
BBBBDDDDDDDDDDDDDDDDBBBB
BBBBDDDDDDDDDDDDDDDDBBBB
BBBBDDDDDDDDDDDDDDDDBBBB
BBBBDDDDDDDDDDDDDDDDBBBB
BBBBDDDDDDDDDDDDDDDDBBBB
BBBBDDDDDDDDDDDDDDDDBBBB
BBBBDDDDDDDDDDDDDDDDBBBB
BBBBDDDDDDDDDDDDDDDDBBBB
BBBBDDDDDDDDDDDDDDDDBBBB
BBBBBBBBBBBthBBBBBBBBBBB
BBBBBBBBBBBBBBBBBBBBBBBB