BBBBBBBBBBBBBBBBBBBBBBBB
BBBBBBBBBBBPABBBBBBBBBBB
BBBBDDDDDDDDDDDDDDDDBBBB
BBBBDDDDDDDDDDDDDDDDBBBB
BBBBDDDDDDDDDDDDDDDDBBBB
BBBBDDDDDDDDDDDDDDDDBBBB
BBBBDDDDDDDDDDDDDDDDBBBB
BBBBDDDDDDDDDDDDDDDDBBBB
BBBBDDDDDDDDDDDDDDDDBBBB
BBBBDDDDDDDDDDDDDDDDBBBB
BBBBDDDDDDDDDDDDDDDDBBBB
BBBBDDDDDDDDDDDDDDDDBBBB
BBBBBBBBBBBTHBBBBBBBBBBB
BBBBBBBBBBBBBBBBBBBBBBBB